8,
9,9,
4,4,4,4,4,4,4,4,4,
4,4,4,4,8,4,4,4,4, 
4,4,4,4,2,4,4,4,4,
4,4,4,4,0,4,4,4,4,
4,8,2,0,1,0,2,8,4,
4,4,4,4,0,4,4,4,4,
4,4,4,4,2,4,4,4,4,
4,4,4,4,8,4,4,4,4,
4,4,4,4,4,4,4,4,4,
19,11,
0,0,0,0,4,4,4,4,4,0,0,0,0,0,0,0,0,0,0,
0,0,0,0,4,0,0,0,4,0,0,0,0,0,0,0,0,0,0,
0,0,0,0,4,2,0,0,4,0,0,0,0,0,0,0,0,0,0,
0,0,4,4,4,0,0,2,4,4,0,0,0,0,0,0,0,0,0,
0,0,4,0,0,2,0,2,0,4,0,0,0,0,0,0,0,0,0,
4,4,4,0,4,0,4,4,0,4,0,0,0,4,4,4,4,4,4,
4,0,0,0,4,0,4,4,0,4,4,4,4,4,0,0,8,8,4,
4,0,2,0,0,2,0,0,0,0,0,0,0,0,0,0,8,8,4,
4,4,4,4,4,0,4,4,4,0,4,1,4,4,0,0,8,8,4,
0,0,0,0,4,0,0,0,0,0,4,4,4,4,4,4,4,4,4,
0,0,0,0,4,4,4,4,4,4,4,0,0,0,0,0,0,0,0,
14,11,
0,0,0,0,0,0,0,0,0,0,0,0,0,0,
4,4,4,4,4,4,4,4,4,4,4,4,0,0,
4,8,8,0,0,4,0,0,0,0,0,4,4,4,
4,8,8,0,0,4,0,2,0,0,2,0,0,4,
4,8,8,0,0,4,2,4,4,4,4,0,0,4,
4,8,8,0,0,0,0,1,0,4,4,0,0,4,
4,8,8,0,0,4,0,4,0,0,2,0,4,4,
4,4,4,4,4,4,0,4,4,2,0,2,0,4,
0,0,4,0,2,0,0,2,0,2,0,2,0,4,
0,0,4,0,0,0,0,4,0,0,0,0,0,4,
0,0,4,4,4,4,4,4,4,4,4,4,4,4,
17,10,
0,0,0,0,0,0,0,0,4,4,4,4,4,4,4,4,0,
0,0,0,0,0,0,0,0,4,0,0,0,0,0,1,4,0,
0,0,0,0,0,0,0,0,4,0,2,4,2,0,4,4,0,
0,0,0,0,0,0,0,0,4,0,2,0,0,2,4,0,0,
0,0,0,0,0,0,0,0,4,4,2,0,2,0,4,0,0,
4,4,4,4,4,4,4,4,4,0,2,0,4,0,4,4,4,
4,8,8,8,8,0,0,4,4,0,2,0,0,2,0,0,4,
4,4,8,8,8,0,0,0,0,2,0,0,2,0,0,0,4,
4,8,8,8,8,0,0,4,4,4,4,4,4,4,4,4,4,
4,4,4,4,4,4,4,4,0,0,0,0,0,0,0,0,0,
19,14,
0,0,0,0,0,0,0,0,0,0,0,4,4,4,4,4,4,4,4,
0,0,0,0,0,0,0,0,0,0,0,4,0,0,8,8,8,8,4,
4,4,4,4,4,4,4,4,4,4,4,4,0,0,8,8,8,8,4,
4,0,0,0,0,4,0,0,2,0,2,0,0,0,8,8,8,8,4,
4,0,2,2,2,4,2,0,0,2,0,4,0,0,8,8,8,8,4,
4,0,0,2,0,0,0,0,0,2,0,4,0,0,8,8,8,8,4,
4,0,2,2,0,4,2,0,2,0,2,4,4,4,4,4,4,4,4,
4,0,0,2,0,4,0,0,0,0,0,4,0,0,0,0,0,0,0,
4,4,0,4,4,4,4,4,4,4,4,4,0,0,0,0,0,0,0,
4,0,0,0,0,4,0,0,0,0,4,4,0,0,0,0,0,0,0,
4,0,0,0,0,0,2,0,0,0,4,4,0,0,0,0,0,0,0,
4,0,0,2,2,4,2,2,0,0,1,4,0,0,0,0,0,0,0,
4,0,0,0,0,4,0,0,0,0,4,4,0,0,0,0,0,0,0,
4,4,4,4,4,4,4,4,4,4,4,0,0,0,0,0,0,0,0,
17,13,
0,0,0,0,0,0,0,0,4,4,4,4,4,0,0,0,0,
0,0,0,0,0,0,0,0,4,0,0,0,4,4,4,4,4,
0,0,0,0,0,0,0,0,4,0,4,2,4,4,0,0,4,
0,0,0,0,0,0,0,0,4,0,0,0,0,0,2,0,4,
4,4,4,4,4,4,4,4,4,0,4,4,4,0,0,0,4,
4,8,8,8,8,0,0,4,4,0,2,0,0,2,4,4,4,
4,8,8,8,8,0,0,0,0,2,0,2,2,0,4,4,0,
4,8,8,8,8,0,0,4,4,2,0,0,2,0,1,4,0,
4,4,4,4,4,4,4,4,4,0,0,2,0,0,4,4,0,
0,0,0,0,0,0,0,0,4,0,2,0,2,0,0,4,0,
0,0,0,0,0,0,0,0,4,4,4,0,4,4,0,4,0,
0,0,0,0,0,0,0,0,0,0,4,0,0,0,0,4,0,
0,0,0,0,0,0,0,0,0,0,4,4,4,4,4,4,0,
13,12,
0,0,0,0,0,0,0,4,4,4,4,4,0,
0,4,4,4,4,4,4,4,0,0,0,4,4,
4,4,0,4,0,1,4,4,0,2,2,0,4,
4,0,0,0,0,2,0,0,0,0,0,0,4,
4,0,0,2,0,0,4,4,4,0,0,0,4,
4,4,4,0,4,4,4,4,4,2,4,4,4,
4,0,2,0,0,4,4,4,0,8,8,4,0,
4,0,2,0,2,0,2,0,8,8,8,4,0,
4,0,0,0,0,4,4,4,8,8,8,4,0,
4,0,2,2,0,4,0,4,8,8,8,4,0,
4,0,0,4,4,4,0,4,4,4,4,4,0,
4,4,4,4,0,0,0,0,0,0,0,0,0,
18,15,
0,0,0,0,0,0,0,0,0,0,0,0,0,0,0,0,0,0,
0,0,0,0,0,0,0,0,0,0,4,4,4,4,4,4,4,0,
0,0,0,0,0,0,0,0,0,0,4,0,0,8,8,8,4,0,
0,0,0,0,0,0,4,4,4,4,4,0,0,8,8,8,4,0,
0,0,0,0,0,0,4,0,0,0,0,0,0,8,0,8,4,0,
0,0,0,0,0,0,4,0,0,4,4,0,0,8,8,8,4,0,
0,0,0,0,0,0,4,4,0,4,4,0,0,8,8,8,4,0,
0,0,0,0,0,4,4,4,0,4,4,4,4,4,4,4,4,0,
0,0,0,0,0,4,0,2,2,2,0,4,4,0,0,0,0,0,
0,4,4,4,4,4,0,0,2,0,2,0,4,4,4,4,4,0,
4,4,0,0,0,4,2,0,2,0,0,0,4,0,0,0,4,0,
4,1,0,2,0,0,2,0,0,0,0,2,0,0,2,0,4,0,
4,4,4,4,4,4,0,2,2,0,2,0,4,4,4,4,4,0,
0,0,0,0,0,4,0,0,0,0,0,0,4,0,0,0,0,0,
0,0,0,0,0,4,4,4,4,4,4,4,4,0,0,0,0,0,

